NO ./textures/colorstone.xpm
SO ./textures/greystone.xpm
WE ./textures/mossy.xpm
EA ./textures/wood.xpm

F 164,0,20
C 153,204,255

111111111111111111111
101000001000000000001
101010101011111110001
101010111011111110011
1W0000000000100000001
111111111111111111111
