NO ./textures/colorstone.xpm
SO ./textures/greystone.xpm
WE ./textures/mossy.xpm
EA ./textures/wood.xpm

F 164,0,20
C 153,204,255

111111111111111111111
101000001000000000001
101010101011111110001
10001000001     10001
10001000001     10001
10001000001     10001
10001000001     10001
10001000001     10001
10001000001     10001
10001000001     10001
10001000001     10001
10001000001     10001
10001000001     10001
10001000001     10001
10001000001     10001
10001000001     10001
10001000001     10001
10001000001     10001
10001000001     10001
10001000001     10001
10001000001     10001
10001000001     10001
10001000001     10001
10001000001     10001
10101011101111111001111111111111111111
1W0000000000100000001                1
11111111111111111111111111111111111111
