NO maps/xpm/1.xpm
SO maps/xpm/1 copy.xpm
WE maps/xpm/1 copy 3.xpm
EA maps/xpm/1 copy 2.xpm


F 20,20,20
C 200,200,255

1111
11E1
111
