NO maps/xpm/1.xpm
WE maps/xpm/1 copy 3.xpm
EA maps/xpm/1 copy 2.xpm
SO maps/xpm/1 copy.xpm

F 20,20,0
C 200,200,255

1111
110E1
1101
11111
